﻿~~~~~~~~~~~~~
<<<<<<<<֍<<<.
...........^.
Ξ>>⌄.>>>>⌄.^.
...S>s...S>^.
Ξ>>^.>⌄.>^...
......S>s....
Ξ>>>>>^.>>>⌄.
۝۝۝۝۝۝۝۝<<<.