﻿~~~~~~~~_~~~~
--------֍---.
...........|.
Ξ--w.x----.|.
...S-s...S-y.
Ξ--y.z-.xy...
......S-s....
Ξ-----y.z--|.
.۝۝۝۝۝۝۝--|.
